{
	"name": "north start east end corner 2",
	"appearsin": [1, 2, 3, 4, 5, 6, 7, 8, 9, 10],
	"entrance_pos": [2, 9],
	"exit_pos": [9, 2],
	"available_mobs": ["Slime", "Skeleton", "Zombie"],
	"floor": 
		[
			["s", "s", "s", "s", "s", "s", "s", "#", "#", "#", "#", "#"],
			["s", "s", "s", "s", "s", "s", "s", "#", "s", "s", "s", "#"],
			["s", "s", "s", "s", "s", "s", "s", "#", "s", ".", "s", "#"],
			["s", "s", "s", "s", "s", "s", "s", "#", "s", "s", "s", "#"],
			["s", "s", "s", "s", "s", "s", "s", "#", "#", "d", "#", "#"],
			["s", "s", "s", "s", "s", "s", "s", "s", "#", "s", "#", "s"],
			["s", "s", "s", "s", "s", "s", "s", "s", "#", "m", "#", "s"],
			["#", "#", "#", "#", "#", "s", "s", "s", "#", "s", "#", "s"],
			["#", "s", "s", "s", "#", "#", "#", "#", "#", "d", "#", "s"],
			["#", "s", "!", "s", "d", "s", "m", "s", "d", "s", "#", "s"],
			["#", "s", "s", "s", "#", "#", "#", "#", "#", "#", "#", "s"],
			["#", "#", "#", "#", "#", "s", "s", "s", "s", "s", "s", "s"]
		],
	"background":"#000000",
	"foreground":"#FFFFFF"
}