{
	"name":"West start, south end Corner 1",
	"appearsin":[1,2,3,4,6,7,8,9],
	"entrance_pos":[2,2],
	"exit_pos":[9,9],
	"available_mobs":["Slime","Zombie","Skeleton"],
	"floor":
	[	
		["#","#","#","#","#","s","s","s","s","s","s","s"],
		["#","s","s","s","#","#","#","#","#","#","#","s"],
		["#","s",".","s","d","s","m","s","d","s","#","s"],
		["#","s","s","s","#","#","#","#","#","d","#","s"],
		["#","#","#","#","#","s","s","s","#","s","#","s"],
		["s","s","s","s","s","s","s","s","#","m","#","s"],
		["s","s","s","s","s","s","s","s","#","s","#","s"],
		["s","s","s","s","s","s","s","#","#","d","#","#"],
		["s","s","s","s","s","s","s","#","s","s","s","#"],
		["s","s","s","s","s","s","s","#","s","!","s","#"],
		["s","s","s","s","s","s","s","#","s","s","s","#"],
		["s","s","s","s","s","s","s","#","#","#","#","#"]
	],
	"background":"#000000",
	"foreground":"#FFFFFF"
}