{
    "name": "el",
    "appearsin": [1],
    "entrance_pos": [0,0],
    "exit_pos": [0,0],
    "available_mobs": [],
    "floor": 
		[
			["#","#","#","#","#","#","#","#","#","#","#","#","#","#","#","#","#","#","#","#","#","#","#"],
			["#",".","s","s","m","s","s","m","#","s","s","s","s","s","s","s","s","s","s","s","s","s","#"],
			["#","s","#","#","s","#","#","s","#","s","#","#","#","#","#","#","#","#","#","#","#","s","#"],
			["#","s","#","#","s","#","#","s","#","s","m","s","s","s","s","s","s","s","s","s","#","m","#"],
			["#","s","s","s","m","s","s","m","#","#","#","#","#","#","#","#","#","#","d","#","#","s","#"],
			["#","s","#","#","s","#","#","s","#","s","s","s","s","s","s","s","s","s","s","s","#","s","#"],
			["#","s","#","#","s","#","#","s","#","#","m","#","#","#","#","#","#","#","#","#","#","s","#"],
			["#","m","s","s","c","s","s","m","#","s","s","s","s","s","s","s","s","s","s","s","#","s","#"],
			["#","s","#","#","s","#","#","s","#","#","#","#","#","#","#","#","#","#","#","s","#","s","#"],
			["#","s","#","#","s","#","#","s","#","s","s","s","#","g","s","m","s","s","#","s","#","s","#"],
			["#","g","s","s","m","s","s","m","d","s","#","s","#","g","s","#","s","s","?","s","#","m","#"],
			["#","#","#","#","#","#","#","d","#","#","#","s","#","#","#","#","#","#","#","s","#","s","#"],
			["#","s","s","s","s","s","s","s","#","#","s","s","s","s","s","s","s","s","s","m","#","s","#"],
			["#","s","#","#","#","#","#","#","#","#","#","#","#","#","#","#","#","#","#","#","#","d","#"],
			["#","s","s","s","s","s","#","g","m","s","s","s","s","s","#","g","m","s","s","s","s","s","#"],
			["#","m","#","#","#","s","#","#","#","s","#","#","#","s","#","#","#","s","#","#","#","s","#"],
			["#","?","#","s","#","s","#","s","#","s","#","s","#","s","#","s","#","s","#","s","#","s","#"],
			["#","s","#","#","#","s","#","#","#","s","#","#","#","s","#","#","#","s","#","#","#","s","#"],
			["#","c","#","g","m","s","s","s","s","s","#","g","m","s","s","s","s","s","m","g","#","!","#"],
			["#","#","#","#","#","#","#","#","#","#","#","#","#","#","#","#","#","#","#","#","#","#","#"]
		],
    "background": "#ff00ff",
    "foreground": "white"
}