{
	"name": "falsewall",
	"appearsin": [1],
	"entrance_pos": [9, 1],
	"exit_pos": [1, 9],
	"available_mobs": ["Slime", "Skeleton", "Zombie"], 
	"floor": 
		[
			["#", "#", "#", "#", "#", "#", "#", "#", "#", "#", "#"],
			["#", "c", "c", "#", "s", "s", "s", "s", "s", "!", "#"],
			["#", "c", "c", "#", "s", "s", "s", "s", "s", "s", "#"],
			["#", "#", "|", "#", "#", "#", "#", "|", "#", "#", "#"],
			["#", "g", "g", "g", "|", "s", "s", "s", "s", "s", "#"],
			["#", "g", "g", "g", "#", "|", "#", "#", "#", "#", "#"],
			["#", "g", "g", "g", "#", "s", "s", "s", "s", "s", "#"],
			["#", "#", "#", "#", "#", "#", "#", "#", "|", "#", "#"],
			["#", "s", "s", "s", "s", "s", "s", "s", "s", "s", "#"],
			["#", ".", "s", "s", "s", "s", "s", "s", "s", "s", "#"],
			["#", "#", "#", "#", "#", "#", "#", "#", "#", "#", "#"]
		],
	"background":"#000000",
	"foreground":"#FFFFFF"
}