{
	"name":"Large Maze 2",
	"appearsin":[21,22,23,24,26,27,28,29],
	"entrance_pos":[13,13],
	"exit_pos":[19,13],
	"available_mobs":["Slime"],
	"floor":
		[
			["#","#","#","#","#","s","s","s","s","s","s","s","s","s","s","s","s","s","s","s","s","s","#","#","#","#","#"],
			["#","s","s","s","#","#","#","#","#","#","#","#","#","#","#","s","s","#","#","#","#","#","#","s","m","g","#"],
			["#","s","g","s","d","s","s","s","s","s","s","s","s","s","#","s","s","#","s","s","s","s","d","s","s","m","#"],
			["#","s","m","s","#","#","#","#","#","#","#","#","#","s","#","s","s","#","s","#","#","#","#","s","s","s","#"],
			["#","#","d","#","#","s","s","s","s","s","s","s","#","s","#","s","s","#","s","#","s","s","#","#","d","#","#"],
			["s","#","s","#","s","s","#","#","#","#","#","s","#","s","#","s","s","#","s","#","s","s","s","#","s","#","s"],
			["s","#","s","#","#","#","#","s","?","g","#","s","#","s","#","s","#","#","d","#","#","s","s","#","s","#","s"],
			["s","#","s","s","s","s","d","s","s","?","#","s","#","s","#","#","#","s","s","s","#","s","s","#","s","#","s"],
			["s","#","#","#","#","#","#","s","s","s","#","s","#","s","s","s","d","s","?","s","#","s","s","#","s","#","s"],
			["s","s","s","s","s","s","#","#","d","#","#","s","#","#","#","#","#","m","s","s","#","s","s","#","s","#","s"],
			["s","s","s","s","s","s","s","#","s","#","s","s","s","s","s","s","#","#","#","#","#","s","s","#","s","#","s"],
			["s","s","#","#","#","#","#","#","s","#","s","#","#","#","#","#","s","s","s","s","s","s","#","#","d","#","#"],
			["s","s","#","s","s","s","s","s","s","#","s","#","s","s","s","#","#","#","#","#","#","#","#","s","s","s","#"],
			["s","s","#","s","#","#","#","#","#","#","s","#","s",".","s","d","s","s","s","s","s","s","d","m","g","s","#"],
			["s","s","#","s","#","s","s","#","c","#","s","#","s","s","s","#","#","#","#","#","#","#","#","s","s","s","#"],
			["s","#","#","d","#","#","s","#","s","#","s","#","#","#","#","#","s","s","s","s","s","s","#","#","#","#","#"],
			["s","#","s","s","s","#","#","#","s","#","s","s","s","s","s","s","s","s","s","s","s","s","s","s","s","s","s"],
			["s","#","s","?","s","d","s","s","s","#","s","#","#","#","#","#","s","s","s","s","s","s","#","#","#","#","#"],
			["s","#","s","s","s","#","#","#","#","#","s","#","s","s","s","#","#","#","#","#","#","#","#","g","s","s","#"],
			["s","#","#","d","#","#","s","s","s","s","s","#","s","!","s","d","?","s","s","s","s","s","d","g","s","s","#"],
			["s","s","#","s","#","s","s","s","s","s","s","#","s","s","s","#","#","#","#","#","#","#","#","g","g","s","#"],
			["s","s","#","s","#","s","s","s","s","s","s","#","#","#","#","#","s","s","s","s","s","s","#","#","d","#","#"],
			["s","#","#","d","#","#","s","s","s","s","s","s","s","s","s","s","s","s","s","s","s","s","s","#","s","#","s"],
			["s","#","s","s","g","#","#","#","#","#","#","#","#","#","#","#","#","#","#","#","#","#","#","#","s","#","s"],
			["s","#","s","g","s","d","s","s","s","s","s","s","s","s","s","s","s","s","s","s","s","s","s","s","s","#","s"],
			["s","#","s","s","s","#","#","#","#","#","#","#","#","#","#","#","#","#","#","#","#","#","#","#","#","#","s"],
			["s","#","#","#","#","#","s","s","s","s","s","s","s","s","s","s","s","s","s","s","s","s","s","s","s","s","s"]
		],
	"background":"#000000",
	"foreground":"#FFFFFF"
}