{
	"name":"Large Maze 1",
	"appearsin":[21,22,23,24,26,27,28,29],
	"entrance_pos":[2,2],
	"exit_pos":[24,24],
	"available_mobs":["Slime"],
	"floor":
	[
		["#","#","#","#","#","s","s","s","#","#","#","#","#","s","s","s","s","s","s","s","s","s","#","#","#","#","#"],
		["#","s","s","s","#","s","s","s","#","s","g","s","#","#","#","#","#","#","#","#","#","#","#","s","g","s","#"],
		["#","s",".","s","#","s","s","s","#","s","s","s","d","s","s","s","s","m","s","s","?","s","d","m","g","c","#"],
		["#","s","s","s","#","s","s","s","#","s","s","g","#","#","#","#","#","d","#","#","#","#","#","s","g","s","#"],
		["#","#","d","#","#","s","s","s","#","#","d","#","#","s","s","s","#","s","#","s","s","s","#","#","#","#","#"],
		["s","#","s","#","s","s","s","s","s","#","s","#","s","s","s","s","#","s","#","s","s","s","s","s","s","s","s"],
		["s","#","s","#","s","s","s","s","s","#","s","#","s","s","s","s","#","s","#","s","s","s","s","s","s","s","s"],
		["s","#","s","#","s","s","s","s","s","#","s","#","s","s","s","s","#","s","#","s","s","s","s","s","s","s","s"],
		["#","#","d","#","#","s","s","s","#","#","d","#","#","s","s","#","#","d","#","#","s","s","#","#","#","#","#"],
		["#","s","m","s","#","#","#","#","#","s","m","s","#","s","s","#","s","s","s","#","#","#","#","s","g","s","#"],
		["#","s","s","s","d","s","s","s","d","s","s","s","#","s","s","#","s","s","s","d","s","m","d","s","g","c","#"],
		["#","s","s","s","#","#","#","#","#","s","m","s","#","s","s","#","s","?","s","#","#","#","#","s","g","s","#"],
		["#","#","d","#","#","s","s","s","#","#","d","#","#","s","s","#","#","#","#","#","s","s","#","#","#","#","#"],
		["s","#","s","#","s","s","s","s","s","#","s","#","s","s","s","s","s","s","s","s","s","s","s","s","s","s","s"],
		["s","#","s","#","s","s","s","s","s","#","s","#","s","s","s","s","s","s","s","s","s","s","s","s","s","s","s"],
		["s","#","s","#","s","s","s","s","s","#","s","#","s","s","s","s","s","s","s","s","s","s","s","s","s","s","s"],
		["s","#","s","#","s","s","s","s","#","#","d","#","#","s","s","s","#","#","#","#","#","s","s","s","s","s","s"],
		["s","#","s","#","s","s","s","s","#","s","s","s","#","#","#","#","#","s","?","s","#","#","#","#","#","#","s"],
		["s","#","m","#","s","s","s","s","#","s","?","s","d","s","s","s","d","s","s","s","d","s","s","s","s","#","s"],
		["s","#","s","#","s","s","s","s","#","g","s","s","#","#","#","#","#","s","?","s","#","#","#","#","s","#","s"],
		["s","#","s","#","s","s","s","s","#","#","d","#","#","s","s","s","#","#","d","#","#","s","s","#","s","#","s"],
		["s","#","s","#","s","s","s","s","s","#","s","#","s","s","#","s","s","#","s","#","s","s","s","#","s","#","s"],
		["#","#","d","#","#","s","s","s","s","#","s","#","s","#","c","#","s","#","s","#","s","s","#","#","d","#","#"],
		["#","s","?","s","#","s","s","s","s","#","s","#","s","#","s","#","s","#","s","#","s","s","#","s","s","s","#"],
		["#","g","s","g","#","s","s","s","s","#","s","#","s","#","s","#","#","#","s","#","s","s","#","s","!","s","#"],
		["#","s","c","s","#","s","s","s","s","#","g","#","s","#","m","s","s","s","s","#","s","s","#","s","s","s","#"],
		["#","#","#","#","#","s","s","s","s","#","#","#","s","#","#","#","#","#","#","#","s","s","#","#","#","#","#"]
	],
	"background":"#000000",
	"foreground":"#FFFFFF"
}