{
	"name": "room",
	"appearsin": [6, 7, 8, 9],
	"entrance_pos": [0, 0],
	"exit_pos": [0, 0],
	"available_mobs": ["Skeleton", "Zombie", "Iron Shell Crab"],
	"floor": 
		[
			["#", "#", "#", "#", "#", "#", "#", "#", "#", "#", "#", "#"],
			["#", "g", "s", "s", "s", "#", "#", "s", "s", "s", ".", "#"],
			["#", "s", "s", "s", "s", "s", "s", "s", "s", "s", "s", "#"],
			["#", "m", "#", "?", "#", "#", "#", "#", "m", "#", "s", "#"],
			["#", "s", "#", "?", "s", "s", "s", "s", "s", "#", "s", "#"],
			["#", "s", "#", "s", "s", "g", "g", "s", "s", "#", "s", "#"],
			["#", "s", "#", "s", "s", "s", "s", "s", "?", "#", "s", "#"],
			["#", "s", "#", "m", "#", "#", "#", "#", "?", "#", "m", "#"],
			["#", "s", "s", "s", "s", "s", "s", "s", "s", "s", "s", "#"],
			["#", "!", "s", "s", "g", "#", "#", "c", "s", "s", "s", "#"],
			["#", "#", "#", "#", "#", "#", "#", "#", "#", "#", "#", "#"]
		],
	"background":"#000000",
	"foreground":"#FFFFFF"
}