{
	"name":"Shop",
	"appearsin":[5,15,25,35,45,55,65,75,85,95],
	"entrance_pos":[9,6],
	"exit_pos":[1,6],
	"available_mobs":[""],
	"floor":
	[
		["#","#","#","#","#","#","#","#","#","#","#","#","#"],
		["#","s","s","#","s","s","!","s","s","#","s","s","#"],
		["#","s","s","#","s","s","s","s","s","#","s","s","#"],
		["#","#","#","#","s","s","s","s","s","#","#","#","#"],
		["#","s","s","s","s","#","#","#","s","s","s","s","#"],
		["#","s","s","s","s","#","$","#","s","s","s","s","#"],
		["#","s","s","s","s","s","s","s","s","s","s","s","#"],
		["#","#","#","#","s","s","s","s","s","#","#","#","#"],
		["#","s","s","#","s","s","s","s","s","#","s","s","#"],
		["#","s","s","#","s","s",".","s","s","#","s","s","#"],
		["#","#","#","#","#","#","#","#","#","#","#","#","#"]
	],
	"background":"#000000",
	"foreground":"#FFFFFF"
}