{
	"name": "test",
	"appearsin": [1],
	"entrance_pos": [9, 1],
	"exit_pos": [9, 9],
	"available_mobs": ["Slime"],
	"floor": 
		[
			["#", "#", "#", "#", "#", "#", "#", "#", "#", "#", "#"],
			["#", "s", "s", "s", "s", "s", "s", "s", "s", "s", "#"],
			["#", "#", "#", "#", "#", "#", "s", "s", "s", "s", "#"],
			["#", "m", "c", "g", "?", "#", "s", "s", "s", "s", "#"],
			["#", "s", "s", "s", "s", "d", "s", "s", "s", "s", "#"],
			["#", "s", "s", "s", "s", "#", "#", "#", "|", "#", "#"],
			["#", "s", "s", "s", "s", "#", "s", "s", "s", "s", "#"],
			["#", "s", "s", "s", "s", "#", "s", "s", "s", "s", "#"],
			["#", "s", "s", "s", "$", "#", "s", "s", "s", "s", "#"],
			["#", ".", "#", "#", "#", "#", "#", "#", "#", "!", "#"],
			["#", "#", "#", "#", "#", "#", "#", "#", "#", "#", "#"]
		]
}